%%%%%%%%%%%%%%%%%%%%%%%%%
% D                     %
%                    D  %
%               G       %
%   P                   %
%                       %
%           D           %
%     D               D %
%%%%%%%%%%%%%%%%%%%%%%%%%