%%%%%%%%%%%%%%%%%%%%%%%%%
%                       %
%                       %
%                       %
%   P                 G %
%                       %
%                       %
%                       %
%%%%%%%%%%%%%%%%%%%%%%%%%