%%%%%%
%D   %
%   G%
% P  %
%   D%
%%%%%%